+--+--+--+--+
|           |
+  +--+  +  +
|  |     | g|
+  +  +--+--+
|  |        |
+  +--+--+  +
|      g | g|
+--+--+--+--+